       HHHH
       HW H
   HHHHH  H
HHHH      H
H   DHHH HH
H H H    HH
H H B BHD H
H H  C  H H
H DHB B H H
HH    H H H
 H HHHD   H
 H     HHHH
 HHHHHHHF
