  HHHHHHHH
  H   HD H
 HH  BDDDH
 H  B HCDH
HH HHBH HH
H   B  B H
H   H    H
HHHHHHHW H
      HHHHF