       HHHHHHHHH
HHHHHHHHWHH  DDH
H      B     DDH
H B HB HBHH  DDH
HH HH    HHHHDDH
 H B BHH H  HHHH
 H HH H  H
HH H    HH
H  B   HH
H  HHB H
H  HH  H
HHHHHHHHF