HHHHHHHHHHHHH
H  B B BDXDDH
H B B B XDDDH
H  B B BDXDDH
H B B B XDDDH
H  B B BDXDDH
H B B B XDDDH
H  B B BDXDDH
H B B B XDDDH
H  B B BDXDDH
HWB B B XDDDH
HHHHHHHHHHHHHF