HHHHHHHHHHHHHH
H   HH DDDDDDH
H  HHH DDHDH H
H BH  DDHHD DH
HH H BH H    H
H B  B    H HH
H BH H BHHHB H
HW H H B  H  H
H BH HHBH HB H
H B   H      H
HHH   H HHB HH
  HHHHH     H
      HHHHHHHF