  HHHHHH
  H    HHH
  H B    H
HHH B HH H
HDDD B   H
HDDDBHB HH
HHHH H B H
   H  W  H
   HHHHHHHF