        HHHHHHHH
        H      H
        H  B B H
 HHHHHHHH B B  H
HHDDD  HHHH HH H
HDDDD       HH H
HHDDD  HH BBHH HH
 HHHHHHHH B    WH
      HHH HHHH HH
      H B B    H
      H  B HHHHH
      HH   H
       HHHHHF 
