     HHHHHH
 HHHHHD   H
 H  HDDHH H
 H  BDD   H
 H  H DH HH
HHH HHBH  H
H B    BB H
H HBH  H  H
HW  HHHHHHH
HHHHHF