   HHHHHHH
 HHH     H
HH   H H H
H  HDBBB H
H HDBH HHH
H  DDH H  
HHHDDB HH 
  HDH B H 
 HH H HWH 
 H B  B H 
 H     HH 
 HHHHHHHF    
