 HHHHHHH
 H     HHH
HHBHHH   H
H W B  B H
H DDH B HH
HHDDH   H
 HHHHHHHHF
