HHHHHHHHHHHHHHHHHH
H         HH HDDDH
H B BBH    B HDDDH
H B   HBHHBB HDDDH
H BBHB       WDDDH
H B B BHB HHHH  DH
H   HH       BDDDH
HHHHHHHHHHHHHHHHHHF