  HHHH
  H  HHHHHHHHHHH
  H    B   B B H
  H BH B H  B  H
  H  B B  H    H
HHH BH H  HHHH H
HWHB B B  HH   H
H    B HBH   H H
HH  B    B B B H
 HHHH HHHHHHHHHH
 HHHH HHH
 H      H
 H      H
 HDDDDDDH
 HDDDDDDH
 HDDDDDDH
 HHHHHHHHF