HHHH    HHHH
HDDHHHHHHDDH
HDDDDDDDDDDH
H B B B B BH
HB B BWB B H
H B B B B BH
HB B B B B H
HDDDDDDDDDDH
HDDHHHHHHDDH
HHH     HHHHF