      HHHHHHHHHHH
      H     H   HH
      H B      DDH
      H     HBHDDH
  HHHHHHHHHHH  DDH
  H      B     DDH
  H H H BHH H HDDH
  H   HB    H  DDH
 HHBH B HHHHHHH  H
HH   B  H    H B H
H   B  HH    H   H
H  B   HH    HHHHH
H BHHHHH
H WH
HHHHF