HHHHHH  HHHHH
H    HHHH   H
H B   B   H H
HH  H HHH B H
 HBB  HHHBH H
HH   H  DDD H
H  H B  BDDDH
H  HHHHHDDHHH
H WH   HHHH  
HHHHF