  HHHHHHHHHHHHHHHHHH
  H       HHDDDH   H
  H HBHBH HHHDDD B H
  H  WB  B   DDH B H
HHHHHBHBH H  DD  HHH
H   B B H HHHHHH HH
H H H H H         H
H       HHHHHHH   H
HHHHHHHHH     HHHHHF
