          HHHHH
    HHHHHHH   HHHHHH
   HH    HH H      H
   H  H B H   B BB H
   HB H     HHHBHWBH
  HH  HBHHHHHHH BB HHHH
HHH  HH  B  HHH    H  H
H B B H H   HH  H  BB H
H   B   B B HH  HBHH  H
HHHHH H  B  HHH    H HH
    H HHH  BBDDDH  H H
    H HHHHHDHHHDD BB HH
   HHBHHDDDDDDHDHH    H
   H    DDDH  HDH  BH H
   H   HDHDDDDDCD  B  H
   HHHHHHHHDD HD HHH  H
          HHHHHHHH HHHHF
