 HHHHH             
 H H HHHHHH
 H      BWHHHHHH
 H B HHB HHH   H
 H HHHH B    B H
 H HHHHH H  HB HHHH
HH  HHHH HHB      H
H  BH  B  H HH HH H
H         H HDDDH H
HHHHHH  HHH  DDD  H
     HHHH H HDDDH H
          H HHH H H
          H H     H
          HHHHHHHHHF