         HHHH
 HHHHHHHHH  HH
HH  B      B HHHHH
H   HH HH   HHDDDH
H HBB B BBHBHHDDDH
H H    W  H   DDDH
H  BH HHHBB   DDDH
H B  BB  B HHDDDDH
HHHB       HHHHHHH
  H  HHHHHHH
  HHHHF