       HHHHH
  HHHHHH   H
HHH    D B H
H B  HBDHBHH
H  H  WDH  H
HH HHHHD   H
 H B  HCHHHH
 H HH HD  H 
 HHHB     H
   H  HHHHH
   HHHHF     