    HHHHHHHHH
  HHH   HH  HHHHH
HHH      H  H   HHHH
H  BB HB H  H  DDD H
H H  BHWBHH H HDHD H
H  HH HB  H    DDD H
H BH    B H H HDHD H
H    HH  HHB B DDD H
H B HH   H  HBHDHD H
HH BB  B   B  BDDD H
 HB  HHHHHH    HH  H
 H   H    HHHHHHHHHH
 HHHHHF